6.ox
.....o..
........
.....o..
........
o.......
........